1000000000
3 1
0 0
.........................
................XX.......
................X........
..........X...X.X.XXXXXXX
..........X...X..........
XXXXXXXX..X...X..........
.......X..X...XXX........
...S...X..X.....X........
.......X..X.....X........
.......X........X.......H
