50
3 1
2 1
..H......................
................XX.......
................X........
..........X...X.X.XXXXXXX
..........X...X..........
XXXXXXXX..X...XH.........
..........X...XXX........
..........X.....X........
.S........X.....X........
................X.......H
